111111111111111
1P00000C0X00001
100000000X000E1
111111111111111
