11111
1CE01
11001
1P001
11111
