1111111111111
1001000000001
10000111110011
1P0011E000001
1111111111111
