111111111
1C011C001
110E01101
1P0000X01
100110001
100000001
111111111
