11111
1C011
110E1
1P001
11111
