111111111111111111111111
100000000000000C00000C01
101001010010000010100101
1010010X10101010001001E1
1P0000000C00C00000000001
10C110000100001CC0001111
101001010010000010100101
111111111111111111111111
