111111111111111
10P000000001111
100001111111111
111000001111111
11001100000C111
110111001111111
111100001111111
111111100010C11
110000E00000111
111111111111111
