111111111111111
10P000000001111
100001111000111
111000001111111
11001100000C111
110111001100001
111100X01111111
111101100000011
110000EC0000111
111111111111111
